##############################
#R..E.....#........#...E....E#
#.##.####.#.######.#.####.##.#
#.#..#....#........#....#..#.#
#.#..#.####.######.####.#..#.#
#.E..#....E........E...E#..E.#
#.####.##.########.##.####.#.#
#......#......D.......#....#.#
#.######.####.#.####.######..#
#.#......#..........#......#.#
#.#.####.#.########.#.####.#.#
#.#.#..E.#....##....#.E..#.#.#
#.#.#.##.####.##.####.##.#.#.#
#.E.#.#................#.#.E.#
#.#.#.####.######.####.#.#.#.#
#.#.#......#......#......#.#.#
#.#.########.####.########.#.#
#.#..........#..#..........#.#
#.E..........#..#.........EX.#
##############################
