##############################
#R.E....E.......E.......E....#
#.##.##.###.##.###.##.###.##.#
#.##.##.###===T====##.###.##.#
#.##.##.###.##|###.##.###.##.#
#E......E.....+.....E......E.#
#.##.##.###.##|###.##.###.##.#
#.##.##.###.##|###.##.###.##.#
#.##.##.###.##|###.##.###.##.#
#E......E.....+.....E......E.#
#.##.##.###.##|###.##.###.##.#
#.##.##.###.##|###.##.###.##.#
#.##.##.###.##|###.##.###.##.#
#E......E.....+.....E......E.#
#.##.##.###.##|###.##.###.##.#
#.##.##.###.##+========##.##.#
#.##.##.###.##.###.##.###.##.#
#...E......E........E....E...#
#...........................X#
##############################
